"Pathways"	"Ontology - parents of class"	"Genes of pathway"
"isoleucine biosynthesis I"	"L-isoleucine Biosynthesis" // "Superpathways"	"aspC" // "lysC" // "asd" // "thrA" // "metL" // "thrB" // "thrC" // "ilvD" // "ilvE" // "ilvC" // "ilvH" // "ilvI" // "ilvB" // "ilvN" // "ilvG" // "ilvM" // "tdcB" // "tdcR" // "ilvA"
"isoleucine biosynthesis I (from threonine)"	"L-isoleucine Biosynthesis"	"ilvD" // "ilvE" // "ilvC" // "ilvH" // "ilvI" // "ilvB" // "ilvN" // "ilvG" // "ilvM" // "tdcB" // "tdcR" // "ilvA"
"reductive monocarboxylic acid cycle"	"CO<sub>2</sub> Fixation"	"tdcE" // "ybiY" // "yfiD" // "Z1045" // "pflA" // "pflD" // "pflB" // "pflC" // "fdx"
"mannitol degradation I"	"Sugar Alcohol Degradation"	"mtlD"
"lactose degradation III"	"Lactose Degradation"	"lacZ"
"superpathway of hexitol degradation (bacteria)"	"Sugar Alcohol Degradation" // "Superpathways"	"mtlD" // "Z5618" // "srlD" // "gatZ" // "agaZ" // "gatY" // "agaY" // "gatD" // "pykF" // "pykA" // "eno" // "gpmA" // "yibO" // "gpmB" // "pgk" // "gapA" // "gapC" // "tpiA" // "Z2811" // "fba" // "Z4881" // "yihT" // "Z5687" // "sgaE" // "pfkB" // "pfkA" // "ppsA" // "fbp"
"anhydromuropeptides recycling"	"Anhydromuropeptide Recycling"	"amiA" // "nagA" // "mrsA" // "glmU"
"D-sorbitol degradation II"	"Sugar Alcohol Degradation"	"Z5618" // "srlD"
"stearate biosynthesis II (bacteria and plants)"	"Stearate Biosynthesis"	"Z1549" // "Z4866" // "Z4865" // "fabG" // "fabA" // "fabZ" // "fabI" // "acpP"
"galactitol degradation"	"Sugar Alcohol Degradation"	"gatZ" // "agaZ" // "gatY" // "agaY" // "gatD"
"thiazole biosynthesis I (E. coli)"	"Thiazole Biosynthesis"	"thiG" // "thiH" // "dxs" // "thiF" // "thiS"
"fatty acid &beta;-oxidation III (unsaturated, odd number)"	"Fatty Acid Degradation"	"fadB"
"fatty acid &beta;-oxidation I"	"Fatty Acid Degradation"	"fadD" // "yafH" // "aidB" // "fadB"
"siroheme biosynthesis"	"Porphyrin Compound Biosynthesis"	"hemX" // "cysG"
"cellulose biosynthesis"	"Primary Cell Wall" // "Polysaccharide Biosynthesis" // "Secondary Cell Wall"	"yhjOP"
"catechol degradation to &beta;-ketoadipate"	"Catechol Degradation"	"ycjG"
"NADH to cytochrome <i>bo</i> oxidase electron transfer"	"Aerobic Respiration" // "Electron Transfer"	"ndh" // "nuoA" // "nuoB" // "nuoC" // "nuoE" // "nuoF" // "nuoG" // "nuoH" // "nuoI" // "nuoJ" // "nuoK" // "nuoL" // "nuoM" // "nuoN" // "cyoA" // "cyoB" // "cyoC" // "cyoD"
"NADH to cytochrome <i>bd</i> oxidase electron transfer"	"Aerobic Respiration" // "Electron Transfer"	"ndh" // "nuoA" // "nuoB" // "nuoC" // "nuoE" // "nuoF" // "nuoG" // "nuoH" // "nuoI" // "nuoJ" // "nuoK" // "nuoL" // "nuoM" // "nuoN" // "cydA" // "cydB"
"glycine cleavage"	"Glycine Degradation"	"Z1548" // "lpdA" // "gcvT" // "gcvP"
"succinate to cytochrome <i>bo</i> oxidase electron transfer"	"Aerobic Respiration" // "Electron Transfer"	"cyoA" // "cyoB" // "cyoC" // "cyoD" // "sdhB" // "sdhC" // "sdhD" // "sdhA"
"hydrogen production V"	"Hydrogen Production"	"fdhF" // "ygbO" // "hyfG" // "hycG" // "Z4351"
"succinate to cytochrome <i>bd</i> oxidase electron transfer"	"Aerobic Respiration" // "Electron Transfer"	"sdhB" // "sdhC" // "sdhD" // "sdhA" // "cydA" // "cydB"
"lipoate salvage I"	"Lipoate Biosynthesis"	"Z5988"
"aerobic respiration (cytochrome c)"	"Aerobic Respiration" // "Electron Transfer"	"sdhB" // "sdhC" // "sdhD" // "sdhA" // "ndh" // "nuoA" // "nuoB" // "nuoC" // "nuoE" // "nuoF" // "nuoG" // "nuoH" // "nuoI" // "nuoJ" // "nuoK" // "nuoL" // "nuoM" // "nuoN" // "Z2790" // "yfeH" // "ygbE"
"lipoate biosynthesis and incorporation I"	"Lipoate Biosynthesis"	"lipA" // "lipB" // "acpP"
"GDP-D-perosamine biosynthesis"	"GDP-sugar Biosynthesis"	"per" // "gmd" // "Z3198"
"cardiolipin biosynthesis I"	"Cardiolipin Biosynthesis"	"pgpA" // "pgpB" // "cls" // "pgsA"
"glycogen degradation II"	"Glycan Degradation" // "Glycogen Degradation"	"malQ" // "glgP" // "malP" // "pgm"
"cardiolipin biosynthesis III"	"Cardiolipin Biosynthesis"	"pgsA" // "pgpA" // "pgpB"
"glycogen degradation I"	"Glycan Degradation" // "Glycogen Degradation"	"malQ" // "pgm" // "malP" // "glgP" // "malZ" // "glk"
"octaprenyl diphosphate biosynthesis"	"Polyprenyl Biosynthesis"	"ispB"
"<i>trans, trans</i>-farnesyl diphosphate biosynthesis"	|All-Trans-Farnesyl-PP-Biosynthesis|	"ispA"
"GDP-L-fucose biosynthesis I (from GDP-D-mannose)"	"GDP-sugar Biosynthesis"	"gmd" // "Z3198" // "fcI"
"GDP-mannose biosynthesis"	"GDP-sugar Biosynthesis"	"pgi" // "manA" // "manB" // "cpsG"
"glutamate degradation VII (to butanoate)"	"Fermentation to Butanoate" // "L-glutamate Degradation" // "Superpathways"	"fadA" // "fadB" // "aidB" // "yafH" // "Z0892" // "Z0895" // "hyfC" // "hyfB" // "hyfG" // "hyfI" // "hyfH" // "hyfF" // "hyfE" // "hyfD" // "hyfA" // "hycD" // "hycC" // "hybC" // "hybA" // "hyaC" // "hyaB" // "hyaA" // "hycB" // "hycF" // "hycE" // "hycG" // "ygbO" // "Z4351" // "acs" // "fdx"
"acetyl-CoA fermentation to butyrate II"	"Fermentation to Butanoate" // "Superpathways"	"fadA" // "ackA" // "tdcD" // "pta" // "aidB" // "yafH"
"flavin biosynthesis I (bacteria and plants)"	"Flavin Biosynthesis"	"ribE" // "Z0516" // "ribB" // "ribD" // "ribA"
"dTDP-<i>N</i>-acetylthomosamine biosynthesis"	"dTDP-sugar Biosynthesis"	"wecD" // "wecE" // "rffH" // "rffG"
"carnitine degradation I"	"Carnitine Degradation"	"caiA" // "caiB" // "caiD" // "caiC"
"ethanol degradation II"	"Ethanol Degradation"	"adhE" // "adhC" // "adhP" // "Z2778" // "yneI" // "Z2275" // "aldA" // "aldH" // "mhpF" // "acs"
"ethanol degradation I"	"Ethanol Degradation"	"adhC" // "adhP" // "adhE" // "mhpF" // "Z2275" // "yneI" // "Z2778"
"histidine biosynthesis"	"L-histidine Biosynthesis"	"hisD" // "hisC" // "hisB" // "hisF" // "hisA" // "hisI" // "hisG"
"glutathionylspermidine biosynthesis"	"Amine and Polyamine Biosynthesis" // "Reductant Biosynthesis"	"gsp"
"gluconeogenesis I"	"Gluconeogenesis"	"pgi" // "fbp" // "Z2811" // "fba" // "Z4881" // "yihT" // "Z5687" // "sgaE" // "gapA" // "gapC" // "pgk" // "gpmA" // "yibO" // "gpmB" // "eno" // "pckA" // "ppc" // "ppsA" // "tpiA" // "Z5352" // "Z4858" // "Z4856" // "Z4353" // "Z4227" // "Z3955" // "Z3802" // "Z3639" // "Z3637" // "Z3604" // "Z3511" // "Z2851" // "Z2691" // "Z2319" // "Z2211" // "Z2186" // "Z1507" // "Z1106" // "yqiB" // "yqhE" // "yjjT" // "yjiL" // "yjcQ" // "yjcP" // "yicF" // "yhhN" // "yhcJ" // "yhbW" // "ygjO" // "ygdL" // "ygcA" // "yfiC" // "yfbB" // "yecP" // "yebH" // "ydiF" // "ybjX" // "ybjP" // "ybjF" // "ybiX" // "ybiP" // "ybiB" // "ybhJ" // "yaiH" // "yagX" // "vacB" // "mdh" // "ylbC" // "sfcA"
"glycine betaine biosynthesis I (Gram-negative bacteria)"	"Betaine Biosynthesis"	"betA" // "betB"
"5-aminoimidazole ribonucleotide biosynthesis II"	"5-Aminoimidazole Ribonucleotide Biosynthesis"	"purF" // "purD" // "purL" // "purM" // "purT"
"5-aminoimidazole ribonucleotide biosynthesis I"	"5-Aminoimidazole Ribonucleotide Biosynthesis"	"purF" // "purD" // "purN" // "purT" // "purL" // "purM"
"superpathway of 5-aminoimidazole ribonucleotide biosynthesis"	"5-Aminoimidazole Ribonucleotide Biosynthesis" // "Superpathways"	"purN" // "purF" // "purD" // "purL" // "purM" // "purT"
"chorismate biosynthesis from 3-dehydroquinate"	"Chorismate Biosynthesis"	"aroC" // "aroA" // "aroL" // "aroK" // "aroE" // "aroD" // "ydiB"
"chorismate biosynthesis I"	"Chorismate Biosynthesis" // "Superpathways"	"aroB" // "aroG" // "aroH" // "aroF" // "aroC" // "aroA" // "aroL" // "aroK" // "aroE" // "aroD" // "ydiB"
"aspartate degradation II"	"Other"	"aspC" // "mdh" // "ylbC" // "sfcA"
"cysteine biosynthesis I"	"L-cysteine Biosynthesis"	"cysE" // "Z2984" // "cysK" // "cysM"
"biotin biosynthesis from 8-amino-7-oxononanoate I"	"Biotin Biosynthesis"	"bioD" // "bioB" // "bioA"
"molybdenum cofactor biosynthesis"	"Molybdenum Cofactor Biosynthesis"	"moaA" // "moaD" // "moaB"
"biotin biosynthesis I"	"Biotin Biosynthesis" // "Superpathways"	"fabF" // "fabI" // "fabZ" // "Z4865" // "bioC" // "Z4866" // "Z1549" // "fabG" // "fabH" // "bioF" // "bioD" // "bioB" // "bioA" // "acpP"
"2-methylcitrate cycle I"	"2-Methylcitrate Cycle"	"fadD" // "prpE" // "acs" // "prpC" // "prpD" // "prpB"
"tRNA processing"	"Nucleic Acid Processing"	"rnd" // "cca" // "rph"
"superpathway of thiamin diphosphate biosynthesis I"	"Superpathways" // "Thiamine Biosynthesis"	"thiD" // "thiC" // "thiL" // "thiJ" // "thiG" // "thiH" // "dxs" // "thiF" // "thiS"
"<i>N</i>-acetylneuraminate and <i>N</i>-acetylmannosamine degradation"	"<i>N</i>-Acetylneuraminate and <i>N</i>-Acetylmannosamine Degradation"	"nanA"
"4-amino-2-methyl-5-diphosphomethylpyrimidine biosynthesis"	"4-amino-2-methyl-5-diphosphomethylpyrimidine biosynthesis"	"thiD" // "thiC"
"guanine and guanosine salvage I"	"Guanine and Guanosine Salvage"	"hpt" // "gpt" // "deoD"
"guanine and guanosine salvage III"	"Guanine and Guanosine Salvage"	"gsk"
"superpathway of guanine and guanosine salvage"	"Guanine and Guanosine Salvage" // "Superpathways"	"hpt" // "gpt" // "deoD" // "gsk"
"glycerol degradation V"	"Glycerol Degradation"	"gldA" // "Z1970" // "Z1971"
"glycerophosphodiester degradation"	"Glycerol Degradation"	"ugpQ" // "glpQ" // "glpB" // "glpC" // "glpD" // "glpA"
"glycerol degradation II"	"Glycerol Degradation"	"gldA" // "Z1970" // "Z1971"
"glycerol and glycerophosphodiester degradation"	"Glycerol Degradation" // "Superpathways"	"glpK" // "ugpQ" // "glpQ" // "glpB" // "glpC" // "glpD" // "glpA"
"superpathway phosphatidate biosynthesis (yeast)"	"Phospholipid Biosynthesis"	"plsB" // "plsC" // "gpsA"
"phospholipid biosynthesis I"	"Phospholipid Biosynthesis" // "Superpathways"	"cls" // "pssA" // "Z5766" // "cdsA" // "Z2318" // "plsC" // "plsB" // "pgsA" // "pgpA" // "pgpB" // "acpP"
"CDP-diacylglycerol biosynthesis I"	"CDP-diacylglycerol Biosynthesis"	"cdsA" // "Z2318" // "plsC" // "plsB"
"CDP-diacylglycerol biosynthesis II"	"CDP-diacylglycerol Biosynthesis"	"cdsA" // "Z2318" // "plsC" // "plsB" // "acpP"
"homolactic fermentation"	"Fermentation to Lactate" // "Superpathways"	"lldD" // "pgi" // "glk" // "pykF" // "pykA" // "eno" // "gpmA" // "yibO" // "gpmB" // "pgk" // "gapA" // "gapC" // "tpiA" // "Z2811" // "fba" // "Z4881" // "yihT" // "Z5687" // "sgaE" // "pfkB" // "pfkA" // "ppsA" // "fbp"
"D-serine degradation"	"D-Amino Acid Degradation"	"dsdA"
"pyrimidine deoxyribonucleosides degradation"	"Pyrimidine Deoxyribonucleoside Degradation"	"cdd" // "udp" // "deoA"
"pyrimidine ribonucleosides degradation"	"Pyrimidine Ribonucleoside Degradation"	"cdd" // "udp"
"arginine degradation III (arginine decarboxylase/agmatinase pathway)"	"L-arginine Degradation"	"adiA" // "speA" // "speB"
"methionine biosynthesis I"	"L-methionine <i>De Novo</i> Biosynthesis"	"metE" // "metH" // "metB" // "metA" // "metC"
"superpathway of methionine biosynthesis (transsulfuration)"	"L-methionine <i>De Novo</i> Biosynthesis" // "Superpathways"	"aspC" // "lysC" // "asd" // "thrA" // "metL" // "metE" // "metH" // "metB" // "metA" // "metC"
"homoserine and methionine biosynthesis"	"L-methionine <i>De Novo</i> Biosynthesis" // "Superpathways"	"metE" // "metH" // "metB" // "metA" // "metC" // "lysC" // "asd" // "thrA" // "metL"
"aspartate biosynthesis"	"L-aspartate Biosynthesis"	"aspC"
"adenosylcobalamin salvage from cobalamin"	"Cobinamide Salvage"	"btuR"
"<i>D</i>-glucarate degradation I"	"D-Glucarate Degradation"	"ygcY" // "ygcX"
"adenosylcobalamin salvage from cobinamide I"	"Adenosylcobalamin Salvage from Cobinamide" // "Superpathways"	"cobU" // "cobT" // "cobB" // "btuR" // "cobS"
"acetoacetate degradation (to acetyl CoA)"	"Degradation/Utilization/Assimilation - Other"	"fadA"
"acrylonitrile degradation I"	"Acrylonitrile Degradation"	"ycbB" // "Z4134" // "ygiC" // "gsp" // "yjfC"
"NAD phosphorylation and dephosphorylation I"	"NAD Metabolism"	"pntA" // "pntB"
"NAD biosynthesis I (from aspartate)"	"NAD Biosynthesis"	"nadE" // "nadC" // "nadA" // "nadB"
"Entner-Doudoroff pathway I"	"Entner-Duodoroff Pathways"	"eda" // "edd"
"NAD salvage pathway I"	"NAD Biosynthesis"	"pncB" // "nadE" // "ycbB" // "Z4134" // "ygiC" // "gsp" // "yjfC"
"methylglyoxal degradation III"	"Methylglyoxal Detoxification"	"gldA"
"UDP-<i>N</i>-acetyl-&alpha;-D-mannosaminouronate biosynthesis"	"UDP-sugar Biosynthesis"	"wecC" // "wecB"
"cinnamate and 3-hydroxycinnamate degradation to 2-oxopent-4-enoate"	"Phenolic Compound Degradation"	"hcaB"
"UDP-&alpha;-D-glucuronate biosynthesis (from UDP-glucose)"	"UDP-sugar Biosynthesis"	"ugd"
"3-phenylpropanoate and 3-(3-hydroxyphenyl)propanoate degradation to 2-oxopent-4-enoate"	"Phenolic Compound Degradation"	"mhpC" // "mhpB" // "mhpA" // "hcaB" // "hcaA2" // "hcaC" // "hcaD" // "hcaA1"
"glycogen biosynthesis I (from ADP-D-Glucose)"	"Glycogen and Starch Biosynthesis"	"glgA" // "glgB" // "glgC" // "pgm"
"UDP-D-galactose biosynthesis"	"UDP-sugar Biosynthesis"	"galE" // "Z3206"
"glycolysis II (from fructose-6P)"	"Glycolysis"	"pykF" // "pykA" // "eno" // "gpmA" // "yibO" // "gpmB" // "pgk" // "gapA" // "gapC" // "tpiA" // "Z2811" // "fba" // "Z4881" // "yihT" // "Z5687" // "sgaE" // "pfkB" // "pfkA" // "ppsA" // "fbp"
"glycolysis I (from glucose-6P)"	"Glycolysis"	"pykF" // "pykA" // "eno" // "gpmA" // "yibO" // "gpmB" // "pgk" // "gapA" // "gapC" // "tpiA" // "Z2811" // "fba" // "Z4881" // "yihT" // "Z5687" // "sgaE" // "pfkB" // "pfkA" // "pgi" // "ppsA" // "fbp"
"UDP-glucose biosynthesis"	"UDP-sugar Biosynthesis"	"galU" // "pgm"
"glycolysis III (from glucose)"	"Glycolysis"	"glk" // "pgi" // "pfkB" // "pfkA" // "Z2811" // "fba" // "Z4881" // "yihT" // "Z5687" // "sgaE" // "tpiA" // "gapA" // "gapC" // "pgk" // "gpmA" // "yibO" // "gpmB" // "eno" // "pykF" // "pykA"
"glutamate biosynthesis III"	"L-glutamate Biosynthesis"	"gdhA" // "gltD" // "gltB"
"glutamate biosynthesis I"	"L-glutamate Biosynthesis"	"gltD" // "gltB"
"crotonate fermentation (to acetate and cyclohexane carboxylate)"	|Fermentation| // "Superpathways"	"acs" // "fadB" // "fadA"
"L-ascorbate biosynthesis IV"	"Ascorbate Biosynthesis"	"galU" // "pgm" // "ugd"
"L-ascorbate biosynthesis V"	"Ascorbate Biosynthesis" // "Superpathways"	"galU" // "pgm" // "ugd"
"superpathway of asparagine biosynthesis"	"L-asparagine Biosynthesis" // "Superpathways"	"asnB" // "asnA"
"mixed acid fermentation"	"Fermentation to Short-Chain Fatty Acids" // "Pyruvate Fermentation to Ethanol"	"pta" // "ackA" // "tdcD" // "tdcE" // "ybiY" // "yfiD" // "Z1045" // "pflA" // "pflD" // "pflB" // "pflC" // "Z2275" // "yneI" // "Z2778" // "adhE" // "adhC" // "adhP" // "pykF" // "pykA" // "ldhA" // "Z0887" // "fumA" // "fumB" // "fumC" // "ppc" // "hycB" // "hycF" // "hycE" // "hycG" // "fdhF" // "frdD" // "frdC" // "frdB" // "frdA" // "gltA" // "prpC" // "acnA" // "acnB" // "icdA" // "mdh" // "ylbC" // "sfcA"
"asparagine biosynthesis II"	"L-asparagine Biosynthesis"	"asnB" // "asnA"
"choline degradation I"	"Choline Degradation"	"betB" // "betA"
"asparagine biosynthesis I"	"L-asparagine Biosynthesis"	"asnB"
"acetate formation from acetyl-CoA I"	"Fermentation to Acetate"	"ackA" // "tdcD" // "pta"
"acetate formation from acetyl-CoA II"	"Fermentation to Acetate"	"acs"
"hexitol fermentation to lactate, formate, ethanol and acetate"	"Fermentation to Acetate" // "Fermentation to Lactate" // "Pyruvate Fermentation to Ethanol" // "Sugar Alcohol Degradation" // "Superpathways"	"lldD" // "ackA" // "tdcD" // "pta" // "tdcE" // "ybiY" // "yfiD" // "Z1045" // "pflA" // "pflD" // "pflB" // "pflC" // "Z2275" // "yneI" // "Z2778" // "adhE" // "adhC" // "adhP" // "mhpF" // "Z5618" // "srlD" // "mtlD" // "pykF" // "pykA" // "eno" // "gpmA" // "yibO" // "gpmB" // "pgk" // "gapA" // "gapC" // "tpiA" // "Z2811" // "fba" // "Z4881" // "yihT" // "Z5687" // "sgaE" // "pfkB" // "pfkA" // "ppsA" // "fbp"
"galactose degradation I (Leloir pathway)"	"Galactose Degradation"	"galK" // "wcaK" // "galT" // "galE" // "Z3206" // "ycjU" // "galM" // "yihR"
"4-hydroxybenzoate biosynthesis II (bacteria and fungi)"	"4-Hydroxybenzoate Biosynthesis"	"ubiC"
"alanine degradation I"	"L-alanine Degradation"	"dadX" // "alr" // "dadA"
"formaldehyde assimilation II (RuMP Cycle)"	"Formaldehyde Assimilation"	"sgaH" // "pfkB" // "pfkA" // "Z2811" // "fba" // "Z4881" // "yihT" // "Z5687" // "sgaE" // "talB" // "mipB" // "talA" // "talC" // "tktA" // "tktB" // "rpe" // "rpiA"
"guanylyl molybdenum cofactor biosynthesis"	"Cofactor, Prosthetic Group, Electron Carrier, and Vitamin Biosynthesis"	"mobB"
"S-adenosyl-L-methionine biosynthesis"	"Cofactor, Prosthetic Group, Electron Carrier, and Vitamin Biosynthesis"	"metK"
"citrate lyase activation"	"Cofactor, Prosthetic Group, Electron Carrier, and Vitamin Biosynthesis"	"citG" // "citC"
"superpathway of <i>N</i>-acetylglucosamine, <i>N</i>-acetylmannosamine and <i>N</i>-acetylneuraminate degradation"	"Amine and Polyamine Degradation" // "Superpathways"	"nagB" // "nagA" // "nanA"
"tetrahydromonapterin biosynthesis"	"Cofactor, Prosthetic Group, Electron Carrier, and Vitamin Biosynthesis"	"folX"
"ethanolamine utilization"	"Amine and Polyamine Degradation"	"eutC" // "eutB"
"acyl carrier protein metabolism I"	"Cofactor, Prosthetic Group, Electron Carrier, and Vitamin Biosynthesis" // "Interconversions"	"acpD" // "Z1544" // "acpS" // "acpP"
"adenine and adenosine salvage III"	"Adenine and Adenosine Salvage"	"deoD" // "add" // "gpt" // "hpt"
"4-aminobutyrate degradation II"	"4-Aminobutanoate Degradation"	"goaG" // "gabT" // "gabD"
"adenine and adenosine salvage I"	"Adenine and Adenosine Salvage"	"deoD" // "apt"
"adenosylcobalamin biosynthesis from cobyrinate <i>a,c</i>-diamide II"	"Adenosylcobalamin Biosynthesis from Cobyrinate Diamide"	"cobU" // "cobS" // "cobT" // "cobB"
"pyrimidine deoxyribonucleotide phosphorylation"	"Metabolic Clusters" // "Pyrimidine Nucleotide Salvage"	"yceG" // "tmk" // "cmk" // "ndk"
"purine deoxyribonucleosides salvage"	"Metabolic Clusters" // "Purine Nucleotide Salvage"	"gmk" // "ndk"
"adenine and adenosine salvage IV"	"Adenine and Adenosine Salvage"	"gpt" // "hpt" // "yicP" // "apt"
"pyrimidine deoxyribonucleotides <i>de novo</i> biosynthesis I"	"Metabolic Clusters" // "Pyrimidine Deoxyribonucleotide <i>De Novo</i> Biosynthesis"	"dut" // "thyA" // "yceG" // "tmk" // "ndk" // "nrdB" // "nrdA" // "nrdF" // "nrdE" // "trxA"
"superpathway of aspartate and asparagine biosynthesis; interconversion of aspartate and asparagine"	"Amino Acid Biosynthesis" // "Superpathways"	"aspA" // "aspC" // "asnB" // "asnA" // "ansA" // "ansB"
"superpathway of leucine, valine, and isoleucine biosynthesis"	"Amino Acid Biosynthesis" // "Superpathways"	"leuB" // "leuC" // "leuA" // "leuD" // "ilvD" // "ilvE" // "ilvC" // "ilvH" // "ilvI" // "ilvB" // "ilvN" // "ilvG" // "ilvM" // "tdcB" // "tdcR" // "ilvA"
"xanthine and xanthosine salvage"	"Purine Nucleotide Salvage"	"deoD"
"superpathway of phenylalanine, tyrosine, and tryptophan biosynthesis"	"Amino Acid Biosynthesis" // "Superpathways"	"aroB" // "aroG" // "aroH" // "aroF" // "aroC" // "aroA" // "aroL" // "aroK" // "aroE" // "aroD" // "ydiB" // "trpC" // "trpE_1" // "trpD" // "trpE_2" // "ubiC" // "trpB" // "trpA" // "hisC" // "tyrB" // "pheA" // "tyrA"
"adenine and adenosine salvage V"	"Adenine and Adenosine Salvage"	"deoD" // "add" // "gsk"
"superpathway of lysine, threonine and methionine biosynthesis I"	"Amino Acid Biosynthesis" // "Superpathways"	"thrB" // "thrC" // "aspC" // "dapF" // "lysA" // "dapE" // "dapD" // "dapA" // "asd" // "lysC" // "thrA" // "metL" // "metE" // "metH" // "metB" // "metA" // "metC"
"formylTHF biosynthesis"	"Folate Transformations"	"purU" // "Z0055" // "glyA" // "folD" // "lpdA" // "gcvT" // "gcvP" // "metF" // "metH" // "thyA" // "folC"
"superpathway of serine and glycine biosynthesis I"	"Amino Acid Biosynthesis" // "Superpathways"	"serC" // "serA" // "serB" // "glyA"
"<i>N</i>-acetylglucosamine degradation I"	"<i>N</i>-acetylglucosamine degradation"	"nagB" // "nagA"
"folate transformations I"	"Folate Transformations"	"purU" // "glyA" // "folD" // "lpdA" // "gcvT" // "gcvP" // "metH" // "metF" // "fdx"
"fatty acid biosynthesis initiation I"	"Fatty Acid Biosynthesis Initiation"	"accC" // "accB" // "accA" // "accD" // "fabD" // "fabH" // "Z1549" // "Z4866" // "Z4863" // "acpP"
"urea degradation II"	"Urea Degradation"	"ureC" // "ureB" // "ureA" // "ureD" // "ureF" // "ureG" // "ureA_2" // "ureB_2" // "ureC_2" // "ureD_2" // "ureF_2" // "ureG_2"
"glutamate degradation VI (to pyruvate)"	"L-glutamate Degradation"	"Z0892" // "Z0895"
"glutamate degradation II"	"L-glutamate Degradation"	"aspC" // "aspA"
"vibriobactin biosynthesis"	"Siderophore Biosynthesis" // "Superpathways"	"entC" // "menF" // "entB" // "entA" // "entE"
"glutamate degradation IX (via 4-aminobutyrate)"	"L-glutamate Degradation" // "Superpathways"	"gadB" // "gadA" // "panD" // "goaG" // "gabT" // "gabD"
"enterobactin biosynthesis"	"Siderophore Biosynthesis" // "Superpathways"	"entD" // "entF" // "entE" // "entC" // "menF" // "entB" // "entA"
"glutamate dependent acid resistance"	"Acid Resistance" // "L-glutamate Degradation"	"gadB" // "gadA" // "panD"
"arginine dependent acid resistance"	"Acid Resistance"	"adiA" // "speA"
"asparagine degradation I"	"L-asparagine Degradation"	"ansA" // "ansB"
"cyclopropane fatty acid (CFA) biosynthesis"	"Cyclopropane Fatty Acid Biosynthesis"	"cfa"
"valine degradation I"	"L-valine Degradation"	"ilvE" // "fadB"
"glycerol degradation to butanol"	"Fermentation to Alcohols" // "Superpathways"	"gldA" // "Z1970" // "Z1971" // "tpiA" // "gapA" // "gapC" // "pgk" // "gpmA" // "yibO" // "gpmB" // "eno" // "pykF" // "pykA" // "fadA" // "fdx"
"arginine biosynthesis IV (archaebacteria)"	"L-arginine Biosynthesis"	"argG" // "argH" // "argI" // "carB" // "carA" // "argB" // "argC"
"arginine biosynthesis I (via L-ornithine)"	"L-arginine Biosynthesis" // "Superpathways"	"argG" // "argH" // "argI" // "carB" // "carA" // "argA" // "agaS" // "argB" // "argC" // "cstC" // "argD" // "argE"
"trehalose degradation I (low osmolarity)"	"Trehalose Degradation"	"treC" // "glk"
"trehalose degradation II (trehalase)"	"Trehalose Degradation"	"treA" // "treC" // "treF" // "glk" // "yihR" // "galM"
"proline degradation"	"L-proline Degradation"	"putA"
"UMP biosynthesis"	"UMP Biosynthesis"	"carB" // "carA" // "pyrB" // "pyrI" // "pyrC" // "pyrE" // "pyrF" // "pyrD"
"superpathway of tetrahydrofolate biosynthesis and salvage"	"Folate Biosynthesis" // "Superpathways"	"folP" // "folC" // "Z0055" // "folK" // "folE" // "pabA" // "pabB" // "pabC" // "folD" // "purN" // "purT"
"folate polyglutamylation"	"Folate Biosynthesis"	"glyA" // "folC"
"TCA cycle I (prokaryotic)"	"TCA cycle"	"Z0887" // "fumA" // "fumB" // "fumC" // "sucD" // "sucC" // "lpdA" // "sucB" // "sucA" // "icdA" // "gltA" // "prpC" // "acnA" // "acnB" // "sdhB" // "sdhC" // "sdhD" // "sdhA" // "mdh" // "ylbC" // "sfcA"
"4-aminobenzoate biosynthesis"	"Folate Biosynthesis"	"pabA" // "pabB" // "pabC"
"palmitate biosynthesis II (bacteria and plants)"	"Palmitate Biosynthesis"	"Z4866" // "Z1549" // "Z4863" // "fabB" // "fabF" // "fabH" // "Z4865" // "fabG" // "fabA" // "fabZ" // "fabI" // "acpP"
"superpathway of tetrahydrofolate biosynthesis"	"Folate Biosynthesis" // "Superpathways"	"folP" // "folC" // "Z0055" // "folK" // "folE" // "pabA" // "pabB" // "pabC"
"tetrahydrofolate salvage from 5,10-methenyltetrahydrofolate"	"Folate Biosynthesis"	"folD" // "purN" // "purT"
"tetrahydrofolate biosynthesis"	"Folate Biosynthesis"	"folP" // "folC" // "Z0055"
"6-hydroxymethyl-dihydropterin diphosphate biosynthesis I"	"6-Hydroxymethyl-Dihydropterin Diphosphate Biosynthesis"	"folK" // "folE"
"spermidine biosynthesis I"	"Spermidine Biosynthesis"	"speE" // "speD"
"superpathway of purine deoxyribonucleosides degradation"	"Nucleoside and Nucleotide Degradation" // "Superpathways"	"deoD" // "add" // "deoB" // "deoC" // "adhE" // "mhpF" // "Z2275" // "yneI" // "Z2778"
"sulfate activation for sulfonation"	"Activation" // "Sulfur Compound Metabolism"	"cysD" // "cysN" // "cysC"
"purine ribonucleosides degradation"	"Purine Nucleotide Degradation"	"add" // "deoD"
"purine deoxyribonucleosides degradation"	"Purine Nucleotide Degradation"	"deoD" // "add"
"urate biosynthesis/inosine 5'-phosphate degradation"	"Purine Nucleotide Degradation"	"guaB" // "deoD" // "yagT"
"adenosine nucleotides degradation II"	"Adenosine Nucleotide Degradation"	"deoD" // "add" // "yagS" // "yagT"
"adenosine nucleotides degradation III"	"Adenosine Nucleotide Degradation"	"amn"
"pyridoxal 5'-phosphate biosynthesis I"	"Vitamin B<sub>6</sub> Biosynthesis"	"pdxH" // "epd" // "dxs" // "pdxJ" // "pdxB" // "serC" // "pdxA"
"pyridoxal 5'-phosphate salvage I"	"Vitamin B<sub>6</sub> Biosynthesis"	"pdxH" // "pdxK" // "pdxY"
"thiamin diphosphate biosynthesis I (E. coli)"	"Thiamine Diphosphate Biosynthesis"	"thiL" // "thiJ"
"lysine degradation I"	"L-lysine Degradation"	"ldcC" // "cadA"
"D-fructuronate degradation"	"Sugar Acid Degradation"	"uxuB" // "uxuA" // "uxaA" // "kdgK" // "eda"
"D-galacturonate degradation I"	"D-Galacturonate Degradation"	"uxaA" // "kdgK" // "uxaB" // "uxaC"
"adenosylcobalamin biosynthesis from cobyrinate <i>a,c</i>-diamide I"	"Adenosylcobamide Biosynthesis"	"cobU" // "cobS" // "cobT" // "cobB"
"ubiquinol-8 biosynthesis (prokaryotic)"	"Ubiquinol Biosynthesis"	"ubiG" // "ubiX" // "ubiA"
"&beta;-D-glucuronide and D-glucuronate degradation"	"D-Glucuronate Degradation"	"uxaC" // "uidA_2" // "uidA_1"
"tetrapyrrole biosynthesis I (from glutamate)"	"Tetrapyrrole Biosynthesis"	"hemD" // "hemC" // "hemB" // "hemL" // "hemA" // "gor" // "gltX" // "gltU" // "gltV" // "gltW" // "gltT"
"superpathway of &beta;-D-glucuronide and D-glucuronate degradation"	"D-Glucuronate Degradation" // "Superpathways"	"uxuB" // "uxuA" // "uxaA" // "kdgK" // "eda" // "uxaC" // "uidA_2" // "uidA_1"
"2-oxoglutarate decarboxylation to succinyl-CoA"	|Respiration|	"Z4047" // "lpdA" // "sucB" // "sucA"
"8-amino-7-oxononanoate biosynthesis I"	"8-Amino-7-oxononanoate Biosynthesis"	"fabF" // "fabI" // "fabZ" // "Z4865" // "bioC" // "Z4866" // "Z1549" // "fabG" // "fabH" // "bioF" // "acpP"
"nitrate reduction III (dissimilatory)"	"Anaerobic Respiration" // "Electron Transfer" // "Nitrate Reduction"	"fdhF" // "fdoI" // "fdoG" // "fdoH" // "fdnH" // "fdnI" // "fdnG" // "hyfI" // "narH" // "napA" // "narG"
"nitrate reduction IV (dissimilatory)"	"Anaerobic Respiration" // "Nitrate Reduction"	"nrfG" // "nrfF" // "nrfD" // "nrfB" // "nrfC" // "nirC" // "narH" // "napA" // "narG"
"formate to dimethyl sulfoxide electron transfer"	"Anaerobic Respiration" // "Electron Transfer"	"fdhF" // "fdoI" // "fdoG" // "fdoH" // "fdnH" // "fdnI" // "fdnG" // "hyfI" // "Z2579" // "Z3785" // "Z3784" // "Z3783" // "dmsC" // "dmsB" // "dmsA"
"respiration (anaerobic)"	"Anaerobic Respiration"	"pykF" // "pykA" // "aceF" // "aceE" // "lpdA" // "gltA" // "prpC" // "acnA" // "acnB" // "icdA" // "ppc" // "Z0887" // "fumA" // "fumB" // "fumC" // "tdcE" // "ybiY" // "yfiD" // "Z1045" // "pflA" // "pflD" // "pflB" // "pflC" // "eno" // "hycB" // "hycF" // "hycE" // "hycG" // "fdhF" // "frdD" // "frdC" // "frdB" // "frdA" // "mdh" // "ylbC" // "sfcA"
"formate to trimethylamine <i>N</i>-oxide electron transfer"	"Anaerobic Respiration" // "Electron Transfer"	"fdhF" // "fdoI" // "fdoG" // "fdoH" // "fdnH" // "fdnI" // "fdnG" // "hyfI" // "bisC" // "bisZ" // "torC" // "torA"
"phosphopantothenate biosynthesis I"	"Phosphopantothenate Biosynthesis"	"panC" // "apbA" // "panB" // "coaA"
"superpathway of adenosine nucleotides <i>de novo</i> biosynthesis II"	"Purine Nucleotide <i>De Novo</i> Biosynthesis" // "Superpathways"	"purA" // "purB" // "adk" // "fliI" // "Z3799" // "atpB" // "atpE" // "atpF" // "atpH" // "atpA" // "atpG" // "atpD" // "atpC" // "nrdB" // "nrdE" // "nrdA" // "nrdF" // "ndk" // "nrdD" // "trxA"
"L-arabinose degradation I"	"L-arabinose Degradation"	"araA" // "araD" // "araB"
"superpathway of guanosine nucleotides <i>de novo</i> biosynthesis II"	"Purine Nucleotide <i>De Novo</i> Biosynthesis" // "Superpathways"	"guaB" // "hisH" // "guaA" // "gmk" // "nrdE" // "nrdB" // "nrdD" // "nrdA" // "nrdF" // "ndk" // "trxA"
"superpathway of adenosine nucleotides <i>de novo</i> biosynthesis I"	"Purine Nucleotide <i>De Novo</i> Biosynthesis" // "Superpathways"	"purA" // "purB" // "adk" // "fliI" // "Z3799" // "atpB" // "atpE" // "atpF" // "atpH" // "atpA" // "atpG" // "atpD" // "atpC" // "nrdB" // "nrdA" // "nrdF" // "nrdE" // "ndk" // "trxA"
"superpathway of purine nucleotides <i>de novo</i> biosynthesis II"	"Purine Nucleotide <i>De Novo</i> Biosynthesis" // "Superpathways"	"purF" // "purD" // "purL" // "purM" // "purT" // "purC" // "purH" // "purE" // "purK" // "guaB" // "hisH" // "guaA" // "gmk" // "purA" // "purB" // "adk" // "fliI" // "Z3799" // "atpB" // "atpE" // "atpF" // "atpH" // "atpA" // "atpG" // "atpD" // "atpC" // "nrdB" // "nrdE" // "nrdA" // "nrdF" // "ndk" // "nrdD" // "trxA"
"superpathway of guanosine nucleotides <i>de novo</i> biosynthesis I"	"Purine Nucleotide <i>De Novo</i> Biosynthesis" // "Superpathways"	"guaB" // "hisH" // "guaA" // "gmk" // "nrdF" // "nrdE" // "nrdB" // "nrdA" // "ndk" // "trxA"
"adenosine deoxyribonucleotides <i>de novo</i> biosynthesis II"	"Adenosine Deoxyribonucleotide <i>De Novo</i> Biosynthesis"	"nrdB" // "nrdE" // "nrdA" // "nrdF" // "ndk" // "nrdD" // "trxA"
"adenosine deoxyribonucleotides <i>de novo</i> biosynthesis I"	"Adenosine Deoxyribonucleotide <i>De Novo</i> Biosynthesis"	"nrdB" // "nrdA" // "nrdF" // "nrdE" // "ndk" // "trxA"
"phosphatidylglycerol biosynthesis II (non-plastidic)"	"Phosphatidylglycerol Biosynthesis" // "Superpathways"	"cdsA" // "Z2318" // "plsC" // "plsB" // "pgsA" // "pgpA" // "pgpB"
"tRNA charging"	"Aminoacyl-tRNA Charging" // "Metabolic Clusters"	"argS" // "cysS" // "glnS" // "gor" // "gltX" // "ileS" // "leuS" // "valS" // "alaS" // "asnS" // "aspS" // "tyrS" // "trpS" // "thrS" // "serS" // "proS" // "pheM" // "pheT" // "pheS" // "metG" // "yjeA" // "lysS" // "lysU" // "hisS" // "glyQ" // "glyS" // "cysT" // "glnV" // "glnW" // "glnX" // "glnU" // "gltU" // "gltV" // "gltW" // "gltT" // "leuU" // "leuZ" // "leuV" // "leuW" // "leuT" // "leuX" // "valW" // "valT" // "valX" // "valU" // "valY" // "valV" // "valZ" // "alaV" // "alaX" // "alaT" // "alaU" // "asnU" // "asnV" // "asnW" // "asnT" // "aspT" // "aspU" // "aspV" // "tyrV" // "tyrT" // "tyrU" // "trpT" // "thrT" // "thrU" // "thrV" // "thrW" // "serW" // "serT" // "serX" // "serU" // "serV" // "proM" // "proK" // "proL" // "pheU" // "pheV" // "metU" // "metZ" // "metV" // "metW" // "metT" // "metY" // "lysW" // "lysY" // "lysT" // "lysZ" // "lysV" // "hisR" // "glyX" // "glyU" // "glyY" // "glyV" // "glyW" // "glyT"
"phosphatidylglycerol biosynthesis I (plastidic)"	"Phosphatidylglycerol Biosynthesis" // "Superpathways"	"cdsA" // "Z2318" // "plsC" // "plsB" // "pgsA" // "pgpA" // "pgpB" // "acpP"
"guanosine nucleotides degradation III"	"Guanosine Nucleotide Degradation"	"yagT" // "deoD"
"proline biosynthesis I"	"L-proline Biosynthesis"	"proC" // "proA" // "proB"
"proline biosynthesis III"	"L-proline Biosynthesis"	"proB" // "ygjG" // "proC"
"triacylglycerol degradation"	"Fatty Acid and Lipid Degradation"	"ybaC" // "yhjY"
"phospholipases"	"Fatty Acid and Lipid Degradation" // "Metabolic Clusters"	"pldA"
"glycerol degradation I"	"Fatty Acid and Lipid Degradation" // "Glycerol Degradation"	"glpK" // "glpB" // "glpC" // "glpD" // "glpA"
"tyrosine biosynthesis I"	"L-tyrosine Biosynthesis"	"tyrB" // "pheA" // "tyrA"
"superpathway of tyrosine biosynthesis"	"Superpathways" // "L-tyrosine Biosynthesis"	"aroB" // "aroG" // "aroH" // "aroF" // "aroC" // "aroA" // "aroL" // "aroK" // "aroE" // "aroD" // "ydiB" // "tyrB" // "pheA" // "tyrA"
"D-arabinose degradation I"	"D-arabinose Degradation"	"fucI" // "fucK" // "aldH" // "Z2778" // "yneI" // "Z2275" // "aldA"
"lipid IV<sub>A</sub> biosynthesis"	"Fatty Acid and Lipid Biosynthesis" // "Lipopolysaccharide Biosynthesis"	"ybbF" // "lpxD" // "lpxC" // "lpxA" // "acpP"
"superpathway of phenylalanine biosynthesis"	"L-phenylalanine Biosynthesis" // "Superpathways"	"aroB" // "aroG" // "aroH" // "aroF" // "aroC" // "aroA" // "aroL" // "aroK" // "aroE" // "aroD" // "ydiB" // "tyrB" // "hisC" // "pheA" // "tyrA"
"biotin-carboxyl carrier protein assembly"	"Fatty Acid and Lipid Biosynthesis"	"birA" // "accC" // "accD" // "accA" // "accB"
"acyl-CoA hydrolysis"	"Fatty Acid and Lipid Biosynthesis"	"tesB"
"homoserine biosynthesis"	"Other Amino Acid Biosynthesis"	"lysC" // "asd" // "thrA" // "metL"
"phenylalanine biosynthesis I"	"L-phenylalanine Biosynthesis"	"tyrB" // "hisC" // "pheA" // "tyrA"
"&beta;-alanine biosynthesis III"	"&beta; Alanine Biosynthesis"	"panD"
"glutamine degradation I"	"L-glutamine Degradation"	"carA" // "hisH" // "guaA" // "pyrG" // "asnB" // "gltD" // "gltB" // "ybaS" // "yneH" // "carB"
"glutamine degradation II"	"L-glutamine Degradation"	"gltD" // "gltB"
"phosphatidylethanolamine biosynthesis I"	"Phosphatidylethanolamine Biosynthesis" // "Phosphatidylserine Biosynthesis"	"pssA" // "Z5766"
"fatty acid elongation -- saturated"	"Fatty Acid Biosynthesis"	"fabZ" // "fabA" // "fabI" // "fabG" // "Z4865" // "fabH" // "fabF" // "fabB" // "Z4863" // "Z1549" // "Z4866" // "acpP"
"ppGpp biosynthesis"	"Metabolic Regulator Biosynthesis"	"gppA" // "relA" // "spoT" // "ndk"
"superpathway of fatty acid biosynthesis initiation (E. coli)"	"Fatty Acid Biosynthesis" // "Superpathways"	"accC" // "accB" // "accA" // "accD" // "fabD" // "Z1549" // "fabG" // "Z4866" // "Z4863" // "fabB" // "fabF" // "fabH" // "acpP"
"fatty acid biosynthesis initiation III"	"Fatty Acid Biosynthesis"	"Z1549" // "fabG" // "Z4866" // "Z4863" // "fabB" // "fabF" // "acpP"
"fatty acid biosynthesis initiation II"	"Fatty Acid Biosynthesis"	"Z1549" // "fabG" // "Z4866" // "Z4863" // "fabB" // "fabF" // "fabH" // "acpP"
"glyoxylate cycle"	"Generation of Precursor Metabolite and Energy"	"aceB" // "aceA" // "gltA" // "prpC" // "acnA" // "acnB" // "mdh" // "ylbC" // "sfcA"
"superpathway of glycolysis, pyruvate dehydrogenase, TCA, and glyoxylate bypass"	"Generation of Precursor Metabolite and Energy" // "Superpathways"	"aceB" // "aceA" // "Z0887" // "fumA" // "fumB" // "fumC" // "sucD" // "sucC" // "sucB" // "sucA" // "icdA" // "gltA" // "prpC" // "acnA" // "acnB" // "sdhB" // "sdhC" // "sdhD" // "sdhA" // "mdh" // "ylbC" // "sfcA" // "pykF" // "pykA" // "eno" // "gpmA" // "yibO" // "gpmB" // "pgk" // "gapA" // "gapC" // "tpiA" // "Z2811" // "fba" // "Z4881" // "yihT" // "Z5687" // "sgaE" // "pfkB" // "pfkA" // "pgi" // "ppsA" // "fbp" // "aceF" // "aceE" // "lpdA"
"superpathway of glycolysis and Entner-Doudoroff"	"Generation of Precursor Metabolite and Energy" // "Superpathways"	"eda" // "edd" // "pykF" // "pykA" // "eno" // "gpmA" // "yibO" // "gpmB" // "pgk" // "gapA" // "gapC" // "tpiA" // "Z2811" // "fba" // "Z4881" // "yihT" // "Z5687" // "sgaE" // "pfkB" // "pfkA" // "pgi" // "ppsA" // "fbp" // "zwf" // "yjbG"
"<i>cis</i>-vaccenate biosynthesis"	"Unsaturated Fatty Acid Biosynthesis"	"Z4866" // "Z1549" // "fabB" // "Z4865" // "fabG" // "fabA" // "fabZ" // "fabI" // "acpP"
"palmitoleate biosynthesis I"	"Palmitoleate Biosynthesis"	"fabI" // "fabG" // "Z4865" // "Z1549" // "Z4866" // "acpP"
"<i>cis</i>-dodecenoyl biosynthesis"	"(5Z)-dodecenoate Biosynthesis"	"fabI" // "fabG" // "Z4865" // "fabB" // "Z4863" // "fabA" // "fabZ" // "acpP"
"hydrogen oxidation I (aerobic)"	"Hydrogen Oxidation"	"hyaC" // "ygbO" // "hyfG" // "hycG" // "Z4351"
"PRPP biosynthesis I"	"Sugar Phosphate Biosynthesis"	"prsA"
"PRPP biosynthesis II"	"PRPP Biosynthesis"	"deoB" // "phnN"
"pentose phosphate pathway (partial)"	"Pentose Phosphate Pathways"	"rpe" // "tktA" // "tktB"
"pentose phosphate pathway (oxidative branch) I"	"Pentose Phosphate Pathways"	"yjbG" // "zwf" // "gnd"
"pentose phosphate pathway (non-oxidative branch)"	"Pentose Phosphate Pathways"	"talB" // "mipB" // "talA" // "talC" // "tktA" // "tktB" // "rpe" // "rpiA"
"pentose phosphate pathway"	"Pentose Phosphate Pathways" // "Superpathways"	"talB" // "mipB" // "talA" // "talC" // "tktA" // "tktB" // "rpe" // "rpiA" // "yjbG" // "zwf" // "gnd"
"colanic acid building blocks biosynthesis"	"Carbohydrate Biosynthesis" // "Superpathways"	"gmd" // "Z3198" // "fcI" // "pgi" // "manA" // "manB" // "cpsG" // "galU" // "pgm" // "galE" // "Z3206" // "ugd"
"glutathione biosynthesis"	"Reductant Biosynthesis"	"gshA" // "gshB"
"citrulline degradation"	"Other Amino Acid Degradation"	"argI" // "arcC" // "yahI"
"superpathway of hexuronide and hexuronate degradation"	"Superpathways"	"uxaB" // "uxuB" // "uxuA" // "uxaA" // "kdgK" // "eda" // "uxaC" // "uidA_2" // "uidA_1"
"thioredoxin pathway"	"Reductant Biosynthesis"	"trxB" // "trxA"
"glutathione redox reactions II"	"Reductant Biosynthesis"	"gor" // "grxA"
"&gamma;-glutamyl cycle"	"Reductant Biosynthesis" // "Superpathways"	"gshA" // "gshB" // "pepN" // "ggt"
"superpathway of ubiquinol-8 biosynthesis (prokaryotic)"	"Superpathways" // "Ubiquinol Biosynthesis"	"ubiC" // "ubiG" // "ubiX" // "ubiA" // "ispB"
"ADP-L-<i>glycero</i>-&beta;-D-<i>manno</i>-heptose biosynthesis"	"ADP-sugar Biosynthesis"	"yaeD" // "rfaD" // "gmhA"
"superpathway of fucose and rhamnose degradation"	"Superpathways"	"fucA" // "fucK" // "fucI" // "rhaD" // "rhaB" // "rhaA" // "aldH" // "Z2778" // "yneI" // "Z2275" // "aldA" // "aldB" // "lldD" // "fucO"
"superpathway of histidine, purine, and pyrimidine biosynthesis"	"Superpathways"	"hisD" // "hisC" // "hisB" // "hisF" // "hisA" // "hisI" // "hisG" // "purF" // "purD" // "purL" // "purM" // "purT" // "purC" // "purH" // "purE" // "purK" // "guaB" // "hisH" // "guaA" // "gmk" // "purA" // "purB" // "adk" // "fliI" // "Z3799" // "atpB" // "atpE" // "atpF" // "atpH" // "atpA" // "atpG" // "atpD" // "atpC" // "nrdB" // "nrdE" // "nrdA" // "nrdF" // "nrdD" // "carB" // "carA" // "pyrB" // "pyrI" // "pyrC" // "pyrE" // "pyrF" // "pyrD" // "pyrH" // "cmk" // "ndk" // "pyrG" // "prsA" // "deoB" // "phnN" // "trxA"
"pyrimidine ribonucleosides salvage I"	"Pyrimidine Nucleotide Salvage"	"cdd" // "udk"
"threonine biosynthesis"	"Superpathways" // "L-threonine Biosynthesis"	"lysC" // "asd" // "thrA" // "metL" // "thrB" // "thrC" // "aspC"
"1,4-dihydroxy-2-naphthoate biosynthesis I"	"1,4-Dihydroxy-2-Naphthoate Biosynthesis"	"menE" // "menC" // "menF" // "menD" // "yfbB" // "menB"
"CMP phosphorylation"	"Pyrimidine Nucleotide Salvage"	"cmk" // "ndk"
"pyrimidine nucleobases salvage I"	"Pyrimidine Nucleotide Salvage"	"upp"
"superpathway of pyridoxal 5'-phosphate biosynthesis and salvage"	"Superpathways" // "Vitamin B<sub>6</sub> Biosynthesis"	"pdxK" // "pdxY" // "pdxH" // "epd" // "dxs" // "pdxJ" // "pdxB" // "serC" // "pdxA"
"pyruvate oxidation pathway"	"Electron Transfer"	"aceE" // "poxB" // "aceF"
"pyrimidine nucleobases salvage II"	"Pyrimidine Nucleotide Salvage" // "Superpathways"	"codA" // "upp"
"superpathway of pyrimidine nucleobases salvage"	"Pyrimidine Nucleotide Salvage" // "Superpathways"	"pyrH" // "cmk" // "ndk" // "pyrG" // "upp"
"sucrose biosynthesis I (from photosynthesis)"	"Sucrose Biosynthesis" // "Superpathways"	"pgk" // "gapA" // "gapC" // "Z2811" // "fba" // "Z4881" // "yihT" // "Z5687" // "sgaE" // "fbp" // "galU" // "pgm" // "pgi"
"ornithine biosynthesis"	"L-Ornithine Biosynthesis"	"argA" // "agaS" // "argB" // "argC" // "cstC" // "argD" // "argE"
"superpathway of tryptophan biosynthesis"	"Superpathways" // "L-tryptophan Biosynthesis"	"aroB" // "aroG" // "aroH" // "aroF" // "aroC" // "aroA" // "aroL" // "aroK" // "aroE" // "aroD" // "ydiB" // "trpC" // "trpE_1" // "trpD" // "trpE_2" // "ubiC" // "trpB" // "trpA"
"threonine degradation I"	"L-threonine Degradation"	"Z1045" // "pflB" // "yfiD" // "tdcE" // "pflD" // "ybiY" // "pflA" // "pflC" // "pta" // "tdcD" // "ackA" // "tdcB" // "tdcR" // "ilvA"
"pyruvate fermentation to acetate and lactate II"	"Pyruvate Fermentation to Acetate" // "pyruvate fermentation to lactate" // "Superpathways"	"ackA" // "tdcD" // "pta" // "lldD"
"pyruvate fermentation to acetate IV"	"Pyruvate Fermentation to Acetate" // "Superpathways"	"tdcE" // "ybiY" // "yfiD" // "Z1045" // "pflA" // "pflD" // "pflB" // "pflC" // "ackA" // "tdcD" // "pta"
"aspartate superpathway"	"Superpathways"	"thrB" // "thrC" // "aspC" // "dapF" // "lysA" // "dapE" // "dapD" // "dapA" // "asd" // "lysC" // "thrA" // "metL" // "metE" // "metH" // "metB" // "metA" // "metC" // "nadE" // "nadC" // "nadA" // "nadB" // "metK"
"threonine degradation II"	"L-threonine Degradation"	"tdh" // "kbl"
"pyruvate fermentation to acetate and lactate I"	"Pyruvate Fermentation to Acetate" // "pyruvate fermentation to lactate" // "Superpathways"	"aceF" // "aceE" // "lpdA" // "pta" // "ackA" // "tdcD" // "lldD"
"pyruvate fermentation to acetate III"	"Pyruvate Fermentation to Acetate" // "Superpathways"	"acs" // "fdx"
"superpathway of <i>S</i>-adenosyl-L-methionine biosynthesis"	"Superpathways"	"metE" // "metH" // "metB" // "metA" // "metC" // "lysC" // "asd" // "thrA" // "metL" // "metK"
"pyruvate fermentation to acetate II"	"Pyruvate Fermentation to Acetate"	"aceF" // "aceE" // "lpdA" // "pta" // "ackA" // "tdcD"
"L-rhamnose degradation I"	"L-rhamnose Degradation"	"rhaD" // "rhaB" // "rhaA"
"superpathway of glyoxylate bypass and TCA"	"Superpathways" // "TCA cycle"	"aceB" // "aceA" // "Z0887" // "fumA" // "fumB" // "fumC" // "sucD" // "sucC" // "lpdA" // "sucB" // "sucA" // "icdA" // "gltA" // "prpC" // "acnA" // "acnB" // "sdhB" // "sdhC" // "sdhD" // "sdhA" // "mdh" // "ylbC" // "sfcA"
"L-lactaldehyde degradation (anaerobic)"	"Lactaldehyde Degradation"	"fucO"
"UDP-<i>N</i>-acetyl-D-glucosamine biosynthesis I"	"UDP-<i>N</i>-acetyl-D-glucosamine Biosynthesis"	"glmU" // "glmS" // "mrsA" // "pgi"
"L-lactaldehyde degradation (aerobic)"	"Lactaldehyde Degradation"	"aldH" // "Z2778" // "yneI" // "Z2275" // "aldA" // "aldB" // "lldD"
"tryptophan biosynthesis"	"L-tryptophan Biosynthesis"	"trpC" // "trpE_1" // "trpD" // "trpE_2" // "ubiC" // "trpB" // "trpA"
"glycine biosynthesis I"	"Glycine Biosynthesis"	"glyA"
"thiosulfate disproportionation III (rhodanese)"	"Thiosulfate Disproportionation"	"Z2789" // "sseA"
"trehalose biosynthesis III"	"Trehalose Biosynthesis"	"otsB" // "otsA"
"alanine biosynthesis I"	"L-alanine Biosynthesis"	"ilvE" // "dadX" // "alr" // "avtA"
"trehalose biosynthesis II"	"Trehalose Biosynthesis"	"otsA" // "otsB"
"trehalose biosynthesis V"	"Trehalose Biosynthesis"	"malS"
"valine biosynthesis"	"L-valine Biosynthesis"	"ilvD" // "ilvE" // "ilvC" // "ilvG" // "ilvH" // "ilvI" // "ilvM" // "ilvN"
"trehalose biosynthesis I"	"Trehalose Biosynthesis"	"otsA" // "otsB"
"xylose degradation I"	"Xylose Degradation"	"xylB" // "Z4878" // "xylA"
"selenocysteine biosynthesis I (bacteria)"	"L-selenocysteine Biosynthesis"	"selD"
"threonine biosynthesis from homoserine"	"L-threonine Biosynthesis"	"thrB" // "thrC"
"leucine biosynthesis"	"L-leucine Biosynthesis"	"leuB" // "leuC" // "leuA" // "leuD"
"2,3-dihydroxybenzoate biosynthesis"	"Aromatic Compound Biosynthesis"	"entC" // "menF" // "entB" // "entA"
"3-dehydroquinate biosynthesis I"	"3-Dehydroquinate Biosynthesis"	"aroB" // "aroG" // "aroH" // "aroF"
"CMP-KDO biosynthesis II (from D-arabinose 5-phosphate)"	"CMP-3-deoxy-D-<I>manno</I>-octulosonate Biosynthesis" // "CMP-sugar Biosynthesis"	"kdsA" // "kdsB"
"pyruvate fermentation to lactate"	"pyruvate fermentation to lactate"	"lldD"
"guanosine ribonucleotides <i>de novo</i> biosynthesis"	"Purine Riboucleotide <i>De Novo</i> Biosynthesis"	"guaB" // "hisH" // "guaA" // "gmk" // "ndk"
"adenosine ribonucleotides <i>de novo</i> biosynthesis"	"Purine Riboucleotide <i>De Novo</i> Biosynthesis"	"purA" // "purB" // "adk" // "fliI" // "Z3799" // "atpB" // "atpE" // "atpF" // "atpH" // "atpA" // "atpG" // "atpD" // "atpC"
"inosine-5'-phosphate biosynthesis I"	"Inosine-5'-phosphate Biosynthesis"	"purC" // "purB" // "purH" // "purE" // "purK"
"heme biosynthesis from uroporphyrinogen-III I (aerobic)"	"Heme <i>b</i> Biosynthesis"	"hemE" // "hemK" // "hemG" // "hemY" // "hemH" // "hemF"
"superpathway of heme biosynthesis from uroporphyrinogen-III"	"Heme <i>b</i> Biosynthesis" // "Superpathways"	"hemK" // "hemG" // "hemY" // "hemH" // "hemE" // "chuW" // "hemN" // "hemF"
"heme biosynthesis from uroporphyrinogen-III II (anaerobic)"	"Heme <i>b</i> Biosynthesis"	"hemH" // "hemE" // "chuW" // "hemN" // "hemF"
"serine biosynthesis"	"L-serine Biosynthesis"	"serC" // "serA" // "serB"
"L-serine degradation"	"L-serine Degradation"	"sdaA" // "sdaB" // "Z4464"
"D-mannose degradation"	"Sugar Degradation"	"manA"
"D-galactosamine and <i>N</i>-acetyl-D-galactosamine degradation"	"Sugar Degradation"	"Z4489" // "nagA" // "gatZ" // "agaZ" // "gatY" // "agaY"
"cyanate degradation"	"Detoxification" // "Nitrogen Compound Metabolism"	"cynS" // "cynT"
"glucose and glucose-1-phosphate degradation"	"Sugar Degradation"	"agp" // "pgm" // "glk" // "gcd"
"glutamine biosynthesis I"	"Ammonia Assimilation" // "L-glutamine Biosynthesis"	"Z2491" // "glnA"
"2'-deoxy-&alpha;-D-ribose 1-phosphate degradation"	"Sugar Degradation"	"deoB" // "deoC" // "adhE" // "mhpF" // "Z2275" // "yneI" // "Z2778"
"ammonia assimilation cycle III"	"Ammonia Assimilation" // "Superpathways"	"Z2491" // "glnA" // "gltD" // "gltB"
"fructose degradation"	"Sugar Degradation"	"fruK"
"superpathway of pyrimidine deoxyribonucleosides degradation"	"Pyrimidine Nucleotide Degradation" // "Superpathways"	"cdd" // "udp" // "deoA" // "deoB" // "deoC" // "adhE" // "mhpF" // "Z2275" // "yneI" // "Z2778"
"fucose degradation"	"Sugar Degradation"	"fucA" // "fucK" // "fucI"
"glucose and xylose degradation"	"Sugar Degradation" // "Superpathways"	"xylB" // "Z4878" // "xylA" // "gapA" // "gapC" // "pgk" // "gpmA" // "yibO" // "gpmB" // "eno" // "pykF" // "pykA" // "lldD" // "ldhA" // "talB" // "mipB" // "talA" // "talC" // "tktA" // "tktB" // "rpe" // "rpiA" // "yjbG" // "zwf" // "gnd"
"melibiose degradation"	"Sugar Degradation"	"melA"
"arsenate detoxification II (glutaredoxin)"	"Arsenate Detoxification"	"arsC" // "grxA"
"putrescine biosynthesis III"	"Putrescine Biosynthesis"	"speF" // "speC"
"putrescine biosynthesis I"	"Putrescine Biosynthesis"	"adiA" // "speA" // "speB"
"superpathway of acetate utilization and formation"	"Carboxylate Degradation" // "Superpathways"	"acs" // "ackA" // "tdcD" // "pta"
"<i>S</i>-adenosyl-L-methionine cycle I"	"<i>S</i>-adenosyl-L-methionine cycle" // "Superpathways"	"metK" // "metE"
"D-gluconate degradation"	"Carboxylate Degradation"	"gntK"
"pyruvate fermentation to ethanol I"	"Pyruvate Fermentation to Ethanol"	"tdcE" // "ybiY" // "yfiD" // "Z1045" // "pflA" // "pflD" // "pflB" // "pflC" // "Z2275" // "yneI" // "Z2778" // "adhE" // "adhC" // "adhP" // "mhpF"
"superpathway of <i>N</i>-acetylneuraminate degradation"	"Carboxylate Degradation" // "Superpathways"	"nanA" // "nagB" // "nagA" // "pykF" // "pykA" // "eno" // "gpmA" // "yibO" // "gpmB" // "pgk" // "gapA" // "gapC" // "tpiA" // "Z2811" // "fba" // "Z4881" // "yihT" // "Z5687" // "sgaE" // "pfkB" // "pfkA" // "ppsA" // "fbp" // "Z2275" // "yneI" // "Z2778" // "adhE" // "adhC" // "adhP" // "mhpF" // "tdcE" // "ybiY" // "yfiD" // "Z1045" // "pflA" // "pflD" // "pflB" // "pflC" // "ackA" // "tdcD" // "pta"
"glycolate and glyoxylate degradation I"	"Glycolate Degradation"	"gcl" // "ybbQ"
"2-oxopentenoate degradation"	"Carboxylate Degradation"	"mhpD" // "mhpE" // "adhE" // "mhpF" // "Z2275" // "yneI" // "Z2778"
"sucrose degradation I (sucrose phosphotransferase)"	"Sucrose Degradation"	"Z3625" // "Z3624"
"glutaryl-CoA degradation"	"Carboxylate Degradation"	"fadA" // "fadB"
"superoxide radicals degradation"	"Reactive Oxygen Specie Degradation"	"Z3312" // "sodB" // "sodC" // "sodA" // "katG" // "katE"
"citrate degradation"	"Carboxylate Degradation"	"citD" // "citE" // "citF"
"queuosine biosynthesis"	"Queuosine Biosynthesis and Salvage"	"tgt" // "queA"
"acetate conversion to acetyl-CoA"	"Carboxylate Degradation"	"acs"
"superpathway of pyrimidine ribonucleotides <i>de novo</i> biosynthesis"	"Pyrimidine Ribonucleotide <i>De Novo</i> Biosynthesis" // "Superpathways"	"carB" // "carA" // "pyrB" // "pyrI" // "pyrC" // "pyrE" // "pyrF" // "pyrD" // "pyrH" // "cmk" // "ndk" // "pyrG"
"pyruvate decarboxylation to acetyl CoA"	"Acetyl-CoA Biosynthesis" // "Carboxylate Degradation"	"sucB" // "sucA" // "lpdA" // "aceF" // "aceE"
"guanosine deoxyribonucleotides <i>de novo</i> biosynthesis I"	"Guanosine Deoxyribonucleotide <i>De Novo</i> Biosynthesis"	"nrdF" // "nrdE" // "nrdB" // "nrdA" // "ndk" // "trxA"
"UTP and CTP <i>de novo</i> biosynthesis"	"Pyrimidine Ribonucleotide <i>De Novo</i> Biosynthesis"	"pyrH" // "cmk" // "ndk" // "pyrG"
"guanosine deoxyribonucleotides <i>de novo</i> biosynthesis II"	"Guanosine Deoxyribonucleotide <i>De Novo</i> Biosynthesis"	"nrdE" // "nrdB" // "nrdD" // "nrdA" // "nrdF" // "ndk" // "trxA"
"3-phenylpropionate and 3-(3-hydroxyphenyl)propionate degradation"	"Aromatic Compound Degradation" // "Superpathways"	"mhpC" // "mhpB" // "mhpA" // "hcaB" // "hcaA2" // "hcaC" // "hcaD" // "hcaA1" // "mhpD" // "mhpE" // "adhE" // "mhpF" // "Z2275" // "yneI" // "Z2778"
"superpathway of sulfate assimilation and cysteine biosynthesis"	"Sulfur Compound Metabolism" // "Superpathways"	"cysJ" // "cysH" // "cysI" // "cysD" // "cysN" // "cysC" // "cysE" // "Z2984" // "cysK" // "cysM" // "serC" // "serA" // "serB" // "trxA"
"4-hydroxyphenylacetate degradation"	"Aromatic Compound Degradation"	"Z1506" // "Z3503" // "gabD"
"dimethyl sulfoxide degradation"	"Sulfur Compound Metabolism"	"Z3785" // "Z3784" // "Z3783"
"sulfate reduction I (assimilatory)"	"Assimilatory Sulfate Reduction" // "Superpathways"	"cysJ" // "cysH" // "cysI" // "cysD" // "cysN" // "cysC" // "trxA"
"enterobacterial common antigen biosynthesis"	"Lipopolysaccharide Biosynthesis" // "Superpathways"	"wecG" // "Z5304" // "rfe" // "wecD" // "wecE" // "rffH" // "rffG" // "wecC" // "wecB"
"tryptophan degradation II (via pyruvate)"	"L-tryptophan Degradation"	"tnaA"
"superpathway of pyrimidine deoxyribonucleotides <i>de novo</i> biosynthesis"	"Pyrimidine Deoxyribonucleotide <i>De Novo</i> Biosynthesis" // "Superpathways"	"dut" // "thyA" // "yceG" // "tmk" // "nrdB" // "nrdA" // "nrdF" // "nrdE" // "carB" // "carA" // "pyrB" // "pyrI" // "pyrC" // "pyrE" // "pyrF" // "pyrD" // "pyrH" // "cmk" // "ndk" // "pyrG" // "trxA"
"thiamin salvage II"	"Superpathways" // "Thiamine Salvage"	"thiM" // "thiE" // "thiL" // "thiJ" // "pdxK" // "thiD"
"pyrimidine deoxyribonucleotides <i>de novo</i> biosynthesis II"	"Pyrimidine Deoxyribonucleotide <i>De Novo</i> Biosynthesis"	"dcd" // "dut" // "thyA" // "yceG" // "tmk" // "ndk" // "nrdD"
"superpathway of <i>Clostridium acetobutylicum</i> acidogenic fermentation"	"Fermentation of Pyruvate" // "Superpathways"	"fadA" // "fadB" // "aidB" // "yafH" // "ackA" // "tdcD" // "pta" // "fdx"
"superpathway of pyrimidine deoxyribonucleotides <i>de novo</i> biosynthesis (E. coli)"	"Pyrimidine Deoxyribonucleotide <i>De Novo</i> Biosynthesis" // "Superpathways"	"dcd" // "nrdD" // "dut" // "thyA" // "yceG" // "tmk" // "ndk" // "nrdB" // "nrdA" // "nrdF" // "nrdE" // "trxA"
"pyruvate fermentation to butanoate"	"Fermentation to Butanoate" // "Fermentation of Pyruvate"	"fadA" // "fadB" // "aidB" // "yafH" // "fdx"
"thiamin salvage I"	"Thiamine Salvage"	"thiL" // "thiJ"
"hydroxymethylpyrimidine salvage"	"Thiamine Salvage"	"pdxK" // "thiD"
"KDO transfer to lipid IV<sub>A</sub> I"	"Kdo Transfer to Lipid IV<SUB>A</SUB>"	"kdtA"
"lysine biosynthesis I"	"L-lysine Biosynthesis"	"dapF" // "lysA" // "dapE" // "dapD" // "dapA" // "asd" // "lysC" // "thrA" // "metL"
"conversion of succinate to propionate"	"Succinate Degradation"	"sbm" // "ygfG" // "ygfH"
"taurine degradation IV"	"Taurine Degradation"	"tauD"
"isoleucine biosynthesis III"	"L-isoleucine Biosynthesis"	"Z0895" // "ilvH" // "ilvI" // "ilvB" // "ilvN" // "ilvG" // "ilvM" // "ilvC" // "ilvD" // "ilvE"
"formate reduction to 5,10-methylenetetrahydrofolate"	"C1 Compound Utilization and Assimilation"	"folD"
